(supertux-level
  (version 2)
  (name (_ "Great Flood"))
  (author "Andrew L.")
  (target-time 0)
  (sector
    (name "main")
    (music "music/cave.music")
    (ambient-light 1 1 1)
    (background
      (speed 0.5)
      (image-top "images/background/cave2.jpg")
      (image "images/background/cave2.jpg")
      (image-bottom "images/background/cave2.jpg")
    )
    (bouncingsnowball
      (direction "left")
      (sprite "images/creatures/bouncing_snowball/bouncing_snowball.sprite")
      (x 1801)
      (y 630)
    )
    (camera
      (mode "normal")
    )
    (fish
      (sprite "images/creatures/fish/fish.sprite")
      (x 1115)
      (y 622)
    )
    (flyingsnowball
      (sprite "images/creatures/flying_snowball/flying_snowball.sprite")
      (x 326)
      (y 370)
    )
    (flyingsnowball
      (sprite "images/creatures/flying_snowball/flying_snowball.sprite")
      (x 381)
      (y 454)
    )
    (jumpy
      (sprite "images/creatures/snowjumpy/snowjumpy.sprite")
      (x 912)
      (y 519)
    )
    (jumpy
      (sprite "images/creatures/snowjumpy/snowjumpy.sprite")
      (x 2367)
      (y 320)
    )
    (mrbomb
      (direction "left")
      (sprite "images/creatures/mr_bomb/mr_bomb.sprite")
      (x 1429)
      (y 701)
    )
    (snowball
      (direction "left")
      (sprite "images/creatures/snowball/snowball.sprite")
      (x 1939)
      (y 480)
    )
    (spawnpoint
      (name "main")
      (x 100)
      (y 522)
    )
    (stalactite
      (sprite "images/creatures/stalactite/stalactite.sprite")
      (x 194)
      (y 352)
    )
    (tilemap
      (solid #t)
      (z-pos 0)
      (width 75)
      (height 35)
      (tiles
      2391 2391 2391 2391 2391 2391 2391 2391 2391 2391 2391 2391 2391 2391 2391 2391 2391 2391 2391 2391 2391 2391 2391 2391 2391 2391 2391 2391 2391 2391 2391 2391 2391 2391 2391 2391 2391 2391 2391 2391 2391 2391 2391 2391 2391 2391 2391 2391 2391 2391 2391 2391 2391 2391 2391 2391 2391 2391 2391 2391 2391 2391 2391 2391 2391 2391 2391 2391 2391 2391 2391 2391 2391 2391 2391
      2391 2391 2391 2391 2391 2391 2391 2391 2391 2391 2391 2391 2391 2391 2391 2391 2391 2391 2391 2391 2391 2391 2391 2391 2391 2391 2391 2391 2391 2391 2391 2391 2391 2391 2391 2391 2391 2391 2391 2391 2391 2391 2391 2391 2391 2391 2391 2391 2391 2391 2391 2391 2391 2391 2391 2391 2391 2391 2391 2391 2391 2391 2391 2391 2391 2391 2391 2391 2391 2391 2391 2391 2391 2391 2391
      2391 2391 2391 2391 2391 2391 2391 2391 2391 2391 2391 2391 2391 2391 2391 2391 2391 2391 2391 2391 2391 2391 2391 2391 2391 2391 2391 2391 2391 2391 2391 2391 2391 2391 2391 2391 2391 2391 2391 2391 2391 2391 2391 2391 2391 2391 2391 2391 2391 2391 2391 2391 2391 2391 2391 2391 2391 2391 2391 2391 2391 2391 2391 2391 2391 2391 2391 2391 2391 2391 2391 2391 2391 2391 2391
      2391 2391 2391 2391 2391 2391 2391 2391 2391 2391 2391 2391 2391 2391 2391 2391 2391 2391 2391 2391 2391 2391 2391 2391 2391 2391 2391 2391 2391 2391 2391 2391 2391 2391 2391 2391 2391 2391 2391 2391 2391 2391 2391 2391 2391 2391 2391 2391 2391 2391 2391 2391 2391 2391 2391 2391 2391 2391 2391 2391 2391 2391 2391 2391 2391 2391 2391 2391 2391 2391 2391 2391 2391 2391 2391
      2391 2391 2391 2391 2391 2391 2391 2391 2391 2391 2391 2391 2391 2391 2391 2391 2391 2391 2391 2391 2391 2391 2391 2391 2391 2391 2391 2391 2391 2391 2391 2391 2391 2391 2391 2391 2391 2391 2391 2391 2391 2391 2391 2391 2391 2391 2391 2391 2391 2391 2391 2391 2391 2391 2391 2391 2391 2391 2391 2391 2391 2391 2391 2391 2391 2391 2391 2391 2391 2391 2391 2391 2391 2391 2391
      2391 2391 2391 2391 2391 2391 2391 2391 2391 2391 2391 2391 2391 2391 2391 2391 2391 2391 2391 2391 2391 2391 2391 2391 2391 2391 2391 2391 2391 2391 2391 2391 2391 2391 2391 2391 2391 2391 2391 2391 2391 2391 2391 2391 2391 2391 2391 2391 2391 2391 2391 2391 2391 2391 2391 2391 2391 2391 2391 2391 2391 2391 2391 2391 2391 2391 2391 2391 2391 2391 2391 2391 2391 2391 2391
      2391 2391 2391 2391 2391 2391 2391 2391 2391 2391 2391 2391 2391 2391 2391 2391 2391 2391 2391 2391 2391 2391 2391 2391 2391 2391 2391 2391 2391 2391 2391 2391 2391 2391 2391 2391 2391 2391 2391 2391 2391 2391 2391 2391 2391 2391 2391 2391 2391 2391 2394 2394 2394 2394 2394 2394 2394 2394 2394 2394 2394 2394 2394 2394 2394 2394 2394 2394 2394 2394 2394 2394 2394 2394 2394
      2391 2391 2391 2391 2391 2391 2391 2391 2391 2391 2391 2391 2391 2391 2391 2391 2391 2391 2391 2391 2391 2391 2391 2391 2391 2391 2391 2391 2391 2391 2391 2391 2391 2391 2391 2391 2391 2391 2391 2391 2391 2391 2391 2391 2391 2391 2391 2391 2391 2391 0 0 0 0 0 0 0 0 0 0 0 0 0 0 0 0 0 0 0 0 0 0 0 0 0
      2394 2394 2394 2394 2394 2394 2394 2394 2394 2394 2394 2394 2394 2394 2394 2394 2394 2394 2394 2394 2394 2394 2394 2394 2394 2394 2394 2394 2394 2394 2394 2394 2394 2394 2394 2394 2394 2394 2394 2394 2394 2394 2394 2394 2394 2394 2394 2394 2394 2394 0 0 0 0 0 0 0 0 0 0 0 0 0 0 0 0 0 0 0 0 0 0 0 0 0
      0 0 0 0 0 0 0 0 0 0 0 0 0 0 0 0 0 0 0 0 0 0 0 0 0 0 0 0 0 0 0 0 0 0 0 0 0 0 0 0 0 0 0 0 0 0 0 0 0 0 0 0 0 0 0 0 0 0 0 0 0 0 0 0 0 0 0 0 0 0 0 0 0 0 0
      0 0 0 0 0 0 47 0 0 0 0 0 0 0 0 0 0 0 0 0 0 0 0 0 0 0 0 0 0 0 0 0 0 0 0 0 0 0 0 0 0 0 0 0 0 0 0 0 0 0 0 0 0 0 0 0 0 0 0 0 0 0 0 0 0 0 0 2384 2385 2385 2385 2385 2385 2385 2385
      0 0 0 0 0 0 0 0 0 0 0 0 0 0 0 0 0 0 0 0 0 0 0 0 0 0 0 0 0 0 0 0 0 0 0 0 0 0 0 0 0 0 0 0 0 0 0 0 0 0 0 0 0 0 0 0 0 0 47 47 47 47 47 2386 47 0 126 2953 2388 2388 2388 2388 2388 2388 2388
      0 0 0 0 0 0 0 0 0 0 0 0 0 0 0 0 0 0 0 0 0 0 0 0 0 0 0 0 0 0 0 0 0 0 0 0 0 0 0 0 0 0 0 0 0 0 0 0 0 0 0 0 0 0 0 0 0 0 47 0 0 0 0 47 0 0 133 0 132 2390 2391 2391 2391 2391 2391
      0 0 0 0 0 0 0 0 0 0 0 0 0 0 0 0 0 0 0 0 0 0 0 0 0 0 0 0 0 0 0 0 0 0 0 0 0 0 0 0 0 0 0 0 0 0 0 0 0 0 0 0 0 0 0 0 0 0 0 0 0 0 0 47 0 0 133 0 132 2390 2391 2391 2391 2391 2391
      0 0 0 0 0 0 0 2043 2044 0 0 0 0 0 0 0 0 0 0 0 0 0 0 0 0 0 0 0 0 0 0 0 0 0 0 0 0 0 0 0 0 0 0 0 0 0 0 0 0 0 0 0 0 0 0 47 0 0 0 0 0 0 0 47 0 0 133 0 132 2390 2391 2391 2391 2391 2391
      0 0 0 0 0 0 0 59 60 0 0 0 0 0 0 275 276 0 0 0 0 0 0 0 0 0 0 0 0 0 0 0 0 0 0 0 0 0 0 0 0 0 0 0 0 0 0 0 0 0 0 0 0 0 0 0 0 0 0 0 0 0 0 47 0 0 133 0 132 2390 2391 2391 2391 2391 2391
      0 0 0 0 0 0 0 59 60 0 0 0 0 0 0 277 278 0 0 0 0 0 0 0 0 0 0 0 0 0 0 0 0 0 0 0 0 0 0 0 0 0 0 0 0 0 0 0 0 0 0 0 0 0 0 0 0 0 0 0 0 0 0 47 47 47 47 47 47 2960 2391 2391 2391 2391 2391
      0 0 0 0 0 48 0 59 60 0 0 0 0 0 279 287 287 282 0 0 0 0 0 0 0 0 0 0 0 0 0 0 0 0 0 0 0 0 0 0 0 0 0 0 0 0 0 0 0 0 0 0 0 0 0 0 0 0 2949 0 0 0 0 0 0 0 0 0 0 2390 2391 2391 2391 2391 2391
      0 0 0 0 0 0 0 0 60 0 0 0 0 0 279 2043 2044 282 0 0 0 0 0 0 0 0 0 0 57 58 0 0 0 0 0 0 0 0 0 0 0 0 57 58 0 0 0 0 0 0 0 0 0 0 0 0 0 0 2950 0 0 0 0 0 0 0 0 0 0 2390 2391 2391 2391 2391 2391
      76 76 76 48 76 76 76 59 60 76 76 76 76 76 76 59 60 76 76 76 76 76 76 76 76 76 76 76 59 60 76 76 76 76 76 76 76 76 76 76 76 0 59 60 0 0 0 0 0 0 0 0 0 0 0 0 0 0 2951 0 0 0 0 0 0 0 0 0 0 2390 2391 2391 2391 2391 2391
      75 75 75 75 75 75 75 59 60 75 75 75 75 75 75 59 60 75 75 75 75 75 75 75 75 75 75 75 59 60 75 75 75 75 75 75 75 75 75 75 75 75 59 60 0 0 0 0 0 0 0 0 0 0 0 0 0 0 2951 0 0 0 0 0 0 0 0 0 0 2390 2391 2391 2391 2391 2391
      75 75 75 75 75 75 200 59 60 200 200 200 75 75 75 59 60 75 75 75 75 75 75 75 75 75 75 75 59 60 75 75 75 75 75 75 75 75 75 75 75 75 59 60 0 0 0 2953 2954 2954 2954 2954 2954 2954 2954 2954 2954 2954 2395 0 0 0 0 0 83 83 83 83 140 2390 2391 2391 2391 2391 2391
      53 55 55 55 55 55 55 2847 2849 55 55 55 55 55 55 2847 2849 55 55 55 55 55 55 55 55 55 55 55 2847 2849 55 55 55 55 55 55 55 55 55 55 55 55 2847 60 0 0 0 0 0 0 0 0 0 0 0 0 0 0 0 0 0 47 0 0 0 0 0 0 0 2390 2391 2391 2391 2391 2391
      54 56 56 56 56 56 56 2848 2850 56 56 56 56 56 56 2848 2850 56 56 56 56 56 56 56 56 56 56 56 2848 2850 56 56 56 56 56 56 56 56 56 56 56 56 2848 60 0 0 0 0 0 0 0 0 0 0 0 0 0 0 0 0 47 0 0 0 0 0 0 0 0 2390 2391 2391 2391 2391 2391
      75 75 75 75 75 75 200 0 0 200 75 75 75 75 75 0 0 75 75 75 75 75 75 75 75 75 75 0 0 0 0 0 0 0 0 0 0 0 0 0 75 75 59 60 0 0 0 0 0 0 0 0 0 0 0 0 0 0 0 0 0 0 0 0 0 0 0 0 0 2390 2391 2391 2391 2391 2391
      75 75 75 75 75 75 75 59 60 75 75 75 75 75 75 0 0 75 75 75 75 75 75 75 75 75 75 75 75 75 75 75 75 75 75 75 75 75 75 75 75 75 59 60 2384 2385 2385 2385 2385 2385 2385 2385 2385 2385 2385 2385 2385 2385 2385 2385 2385 2385 2385 2385 2385 2385 2385 2385 2385 2390 2391 2391 2391 2391 2391
      2391 2391 2391 2391 2391 2391 2391 2391 2391 2391 2391 2391 2391 2391 2391 2391 2391 2391 2391 2391 2391 2391 2391 2391 2391 2391 2391 2391 2391 2391 2391 2391 2391 2391 2391 2391 2391 2391 2391 2391 2391 2391 2391 2959 2388 2388 2388 2388 2388 2388 2388 2388 2388 2388 2388 2388 2388 2388 2388 2388 2388 2388 2388 2388 2388 2388 2388 2388 2388 2388 2388 2388 2388 2388 2388
      2391 2391 2391 2391 2391 2391 2391 2391 2391 2391 2391 2391 2391 2391 2391 2391 2391 2391 2391 2391 2391 2391 2391 2391 2391 2391 2391 2391 2391 2391 2391 2391 2391 2391 2391 2391 2391 2391 2391 2391 2391 2391 2391 2391 2391 2391 2391 2391 2391 2391 2391 2391 2391 2391 2391 2391 2391 2391 2391 2391 2391 2391 2391 2391 2391 2391 2391 2391 2391 2391 2391 2391 2391 2391 2391
      2391 2391 2391 2391 2391 2391 2391 2391 2391 2391 2391 2391 2391 2391 2391 2391 2391 2391 2391 2391 2391 2391 2391 2391 2391 2391 2391 2391 2391 2391 2391 2391 2391 2391 2391 2391 2391 2391 2391 2391 2391 2391 2391 2391 2391 2391 2391 2391 2391 2391 2391 2391 2391 2391 2391 2391 2391 2391 2391 2391 2391 2391 2391 2391 2391 2391 2391 2391 2391 2391 2391 2391 2391 2391 2391
      2391 2391 2391 2391 2391 2391 2391 2391 2391 2391 2391 2391 2391 2391 2391 2391 2391 2391 2391 2391 2391 2391 2391 2391 2391 2391 2391 2391 2391 2391 2391 2391 2391 2391 2391 2391 2391 2391 2391 2391 2391 2391 2391 2391 2391 2391 2391 2391 2391 2391 2391 2391 2391 2391 2391 2391 2391 2391 2391 2391 2391 2391 2391 2391 2391 2391 2391 2391 2391 2391 2391 2391 2391 2391 2391
      2391 2391 2391 2391 2391 2391 2391 2391 2391 2391 2391 2391 2391 2391 2391 2391 2391 2391 2391 2391 2391 2391 2391 2391 2391 2391 2391 2391 2391 2391 2391 2391 2391 2391 2391 2391 2391 2391 2391 2391 2391 2391 2391 2391 2391 2391 2391 2391 2391 2391 2391 2391 2391 2391 2391 2391 2391 2391 2391 2391 2391 2391 2391 2391 2391 2391 2391 2391 2391 2391 2391 2391 2391 2391 2391
      2391 2391 2391 2391 2391 2391 2391 2391 2391 2391 2391 2391 2391 2391 2391 2391 2391 2391 2391 2391 2391 2391 2391 2391 2391 2391 2391 2391 2391 2391 2391 2391 2391 2391 2391 2391 2391 2391 2391 2391 2391 2391 2391 2391 2391 2391 2391 2391 2391 2391 2391 2391 2391 2391 2391 2391 2391 2391 2391 2391 2391 2391 2391 2391 2391 2391 2391 2391 2391 2391 2391 2391 2391 2391 2391
      2391 2391 2391 2391 2391 2391 2391 2391 2391 2391 2391 2391 2391 2391 2391 2391 2391 2391 2391 2391 2391 2391 2391 2391 2391 2391 2391 2391 2391 2391 2391 2391 2391 2391 2391 2391 2391 2391 2391 2391 2391 2391 2391 2391 2391 2391 2391 2391 2391 2391 2391 2391 2391 2391 2391 2391 2391 2391 2391 2391 2391 2391 2391 2391 2391 2391 2391 2391 2391 2391 2391 2391 2391 2391 2391
      2391 2391 2391 2391 2391 2391 2391 2391 2391 2391 2391 2391 2391 2391 2391 2391 2391 2391 2391 2391 2391 2391 2391 2391 2391 2391 2391 2391 2391 2391 2391 2391 2391 2391 2391 2391 2391 2391 2391 2391 2391 2391 2391 2391 2391 2391 2391 2391 2391 2391 2391 2391 2391 2391 2391 2391 2391 2391 2391 2391 2391 2391 2391 2391 2391 2391 2391 2391 2391 2391 2391 2391 2391 2391 2391
      2394 2394 2394 2394 2394 2394 2394 2394 2394 2394 2394 2394 2394 2394 2394 2394 2394 2394 2394 2394 2394 2394 2394 2394 2394 2394 2394 2394 2394 2394 2394 2394 2394 2394 2394 2394 2394 2394 2394 2394 2394 2394 2394 2394 2391 2391 2391 2391 2391 2391 2391 2391 2391 2391 2391 2391 2391 2391 2391 2391 2391 2391 2391 2391 2391 2391 2391 2391 2391 2391 2391 2391 2391 2391 2391
      )
    )
    (tilemap
      (solid #f)
      (z-pos -100)
      (width 75)
      (height 35)
      (tiles
      0 0 0 0 0 0 0 0 0 0 0 0 0 0 0 0 0 0 0 0 0 0 0 0 0 0 0 0 0 0 0 0 0 0 0 0 0 0 0 0 0 0 0 0 0 0 0 0 0 0 0 0 0 0 0 0 0 0 0 0 0 0 0 0 0 0 0 0 0 0 0 0 0 0 0
      0 0 0 0 0 0 0 0 0 0 0 0 0 0 0 0 0 0 0 0 0 0 0 0 0 0 0 0 0 0 0 0 0 0 0 0 0 0 0 0 0 0 0 0 0 0 0 0 0 0 0 0 0 0 0 0 0 0 0 0 0 0 0 0 0 0 0 0 0 0 0 0 0 0 0
      0 0 0 0 0 0 0 0 0 0 0 0 0 0 0 0 0 0 0 0 0 0 0 0 0 0 0 0 0 0 0 0 0 0 0 0 0 0 0 0 0 0 0 0 0 0 0 0 0 0 0 0 0 0 0 0 0 0 0 0 0 0 0 0 0 0 0 0 0 0 0 0 0 0 0
      0 0 0 0 0 0 0 0 0 0 0 0 0 0 0 0 0 0 0 0 0 0 0 0 0 0 0 0 0 0 0 0 0 0 0 0 0 0 0 0 0 0 0 0 0 0 0 0 0 0 0 0 0 0 0 0 0 0 0 0 0 0 0 0 0 0 0 0 0 0 0 0 0 0 0
      0 0 0 0 0 0 0 0 0 0 0 0 0 0 0 0 0 0 0 0 0 0 0 0 0 0 0 0 0 0 0 0 0 0 0 0 0 0 0 0 0 0 0 0 0 0 0 0 0 0 0 0 0 0 0 0 0 0 0 0 0 0 0 0 0 0 0 0 0 0 0 0 0 0 0
      0 0 0 0 0 0 0 0 0 0 0 0 0 0 0 0 0 0 0 0 0 0 0 0 0 0 0 0 0 0 0 0 0 0 0 0 0 0 0 0 0 0 0 0 0 0 0 0 0 0 0 0 0 0 0 0 0 0 0 0 0 0 0 0 0 0 0 0 0 0 0 0 0 0 0
      0 0 0 0 0 0 0 0 0 0 0 0 0 0 0 0 0 0 0 0 0 0 0 0 0 0 0 0 0 0 0 0 0 0 0 0 0 0 0 0 0 0 0 0 0 0 0 0 0 0 0 0 0 0 0 0 0 0 0 0 0 0 0 0 0 0 0 0 0 0 0 0 0 0 0
      0 0 0 0 0 0 0 0 0 0 0 0 0 0 0 0 0 0 0 0 0 0 0 0 0 0 0 0 0 0 0 0 0 0 0 0 0 0 0 0 0 0 0 0 0 0 0 0 0 0 0 0 0 0 0 0 0 0 0 0 0 0 0 0 0 0 0 0 0 0 0 0 0 0 0
      0 0 0 0 0 0 0 0 0 0 0 0 0 0 0 0 0 0 0 0 0 0 0 0 0 0 0 0 0 0 0 0 0 0 0 0 0 0 0 0 0 0 0 0 0 0 0 0 0 0 0 0 0 0 0 0 0 0 0 0 0 0 0 0 0 0 0 0 0 0 0 0 0 0 0
      0 0 0 0 0 0 0 0 0 0 0 0 0 0 0 0 0 0 0 0 0 0 0 0 0 0 0 0 0 0 0 0 0 0 0 0 0 0 0 0 0 0 0 0 0 0 0 0 0 0 0 0 0 0 0 0 0 0 0 0 0 0 0 0 0 0 0 0 0 0 0 0 0 0 0
      0 0 0 0 0 0 47 0 0 0 0 0 0 0 0 0 0 0 0 0 0 0 0 0 0 0 0 0 0 0 0 0 0 0 0 0 0 0 0 0 0 0 0 0 0 0 0 0 0 0 0 0 0 0 0 0 0 0 0 0 0 0 0 0 0 0 0 0 0 0 0 0 0 0 0
      0 0 0 0 0 0 0 0 0 0 0 0 0 0 0 0 0 0 0 0 0 0 0 0 0 0 0 0 0 0 0 0 0 0 0 0 0 0 0 0 0 0 0 0 0 0 0 0 0 0 0 0 0 0 0 0 0 0 0 0 0 0 0 0 0 0 0 0 0 0 0 0 0 0 0
      0 0 0 0 0 0 0 0 0 0 0 0 0 0 0 0 0 0 0 0 0 0 0 0 0 0 0 0 0 0 0 0 0 0 0 0 0 0 0 0 0 0 0 0 0 0 0 0 0 0 0 0 0 0 0 0 0 0 0 0 0 0 0 0 0 0 0 0 0 0 0 0 0 0 0
      0 0 0 0 0 0 0 0 0 0 0 0 0 0 0 0 0 0 0 0 0 0 0 0 0 0 0 0 0 0 0 0 0 0 0 0 0 0 0 0 0 0 0 0 0 0 0 0 0 0 0 0 0 0 0 0 0 0 0 0 0 0 0 0 0 0 0 0 0 0 0 0 0 0 0
      0 0 0 0 0 0 0 0 0 0 0 0 0 0 0 0 0 0 0 0 0 0 0 0 0 0 0 0 0 0 0 0 0 0 0 0 0 0 0 0 0 0 0 0 0 0 0 0 0 0 0 0 0 0 0 0 0 0 0 0 0 0 0 0 0 0 0 0 0 0 0 0 0 0 0
      0 0 0 0 0 0 0 0 0 0 0 0 0 0 0 0 0 0 0 0 0 0 0 0 0 0 0 0 0 0 0 0 0 0 0 0 0 0 0 0 0 0 0 0 0 0 0 0 0 0 0 0 0 0 0 0 0 0 0 0 0 0 0 0 0 0 0 0 0 0 0 0 0 0 0
      0 0 0 0 0 0 0 0 0 0 0 0 0 0 0 0 0 0 0 0 0 0 0 0 0 0 0 0 0 0 0 0 0 0 0 0 0 0 0 0 0 0 0 0 0 0 0 0 0 0 0 0 0 0 0 0 0 0 0 0 0 0 0 0 0 0 0 0 0 0 0 0 0 0 0
      0 0 0 0 0 0 0 0 0 0 0 0 0 0 0 0 0 0 0 0 0 0 0 0 0 0 0 0 0 0 0 0 0 0 0 0 0 0 0 0 0 0 0 0 0 0 0 0 0 0 0 0 0 0 0 0 0 0 0 0 0 0 0 0 0 0 0 0 0 0 0 0 0 0 0
      0 0 0 0 0 0 0 0 0 0 0 0 0 0 75 0 0 75 0 0 0 0 0 0 0 0 0 0 0 0 0 0 0 0 0 0 0 0 0 0 0 0 57 58 0 0 0 0 0 0 0 0 0 0 0 0 0 0 0 0 0 0 0 0 0 0 0 0 0 0 0 0 0 0 0
      0 0 0 0 0 0 0 0 0 0 0 0 0 0 75 59 75 75 75 75 75 0 0 0 0 0 0 0 59 60 0 0 0 0 0 75 75 75 75 75 0 76 200 0 0 0 0 0 0 0 0 0 0 0 0 0 0 0 0 0 0 0 0 0 0 0 0 0 0 0 0 0 0 0 0
      75 75 75 75 75 75 75 75 75 75 75 75 75 200 75 59 75 75 75 75 75 75 75 75 75 75 0 0 59 60 0 0 0 75 75 75 75 75 75 75 75 75 75 0 0 0 0 0 0 0 0 0 0 0 0 0 0 0 0 0 0 0 0 0 0 0 0 0 0 0 0 0 0 0 0
      75 75 75 75 75 75 75 75 75 75 75 75 75 200 75 59 75 75 75 75 75 200 200 200 200 200 75 75 75 75 75 75 75 75 75 75 75 75 75 75 75 75 75 0 0 0 0 0 0 0 0 0 0 0 0 0 0 0 0 0 0 0 0 0 0 0 0 0 0 0 0 0 0 0 0
      75 75 75 75 75 75 75 75 75 75 75 75 75 200 75 59 75 75 75 75 75 200 200 200 200 200 75 75 75 75 75 75 75 75 75 75 75 75 75 75 75 75 55 0 0 0 0 0 0 0 0 0 0 0 0 0 0 0 0 0 0 0 0 0 0 0 0 0 0 0 0 0 0 0 0
      75 75 75 75 75 75 75 75 75 75 75 75 75 200 75 75 75 75 75 75 75 200 200 200 200 200 75 75 75 75 75 75 75 75 75 75 75 75 75 75 75 75 56 0 0 0 0 0 0 0 0 0 0 0 0 0 0 0 0 0 0 0 0 0 0 0 0 0 0 0 0 0 0 0 0
      75 75 75 75 75 75 75 75 75 75 75 75 75 200 75 75 75 75 75 75 75 200 200 200 200 200 75 75 75 75 75 75 75 75 75 75 75 75 75 75 75 75 75 0 0 0 0 0 0 0 0 0 0 0 0 0 0 0 0 0 0 0 0 0 0 0 0 0 0 0 0 0 0 0 0
      75 75 75 75 75 75 75 75 75 75 75 75 75 200 75 75 75 75 200 75 200 200 200 200 200 200 75 75 75 75 75 75 75 75 75 75 75 75 75 75 75 75 75 0 0 0 0 0 0 0 0 0 0 0 0 0 0 0 0 0 0 0 0 0 0 0 0 0 0 0 0 0 0 0 0
      0 0 0 0 0 0 0 0 0 0 0 0 0 0 0 0 0 0 0 0 0 0 0 0 0 0 0 0 0 0 0 0 0 0 0 0 0 0 0 0 0 0 0 0 0 0 0 0 0 0 0 0 0 0 0 0 0 0 0 0 0 0 0 0 0 0 0 0 0 0 0 0 0 0 0
      0 0 0 0 0 0 0 0 0 0 0 0 0 0 0 0 0 0 0 0 0 0 0 0 0 0 0 0 0 0 0 0 0 0 0 0 0 0 0 0 0 0 0 0 0 0 0 0 0 0 0 0 0 0 0 0 0 0 0 0 0 0 0 0 0 0 0 0 0 0 0 0 0 0 0
      0 0 0 0 0 0 0 0 0 0 0 0 0 0 0 0 0 0 0 0 0 0 0 0 0 0 0 0 0 0 0 0 0 0 0 0 0 0 0 0 0 0 0 0 0 0 0 0 0 0 0 0 0 0 0 0 0 0 0 0 0 0 0 0 0 0 0 0 0 0 0 0 0 0 0
      0 0 0 0 0 0 0 0 0 0 0 0 0 0 0 0 0 0 0 0 0 0 0 0 0 0 0 0 0 0 0 0 0 0 0 0 0 0 0 0 0 0 0 0 0 0 0 0 0 0 0 0 0 0 0 0 0 0 0 0 0 0 0 0 0 0 0 0 0 0 0 0 0 0 0
      0 0 0 0 0 0 0 0 0 0 0 0 0 0 0 0 0 0 0 0 0 0 0 0 0 0 0 0 0 0 0 0 0 0 0 0 0 0 0 0 0 0 0 0 0 0 0 0 0 0 0 0 0 0 0 0 0 0 0 0 0 0 0 0 0 0 0 0 0 0 0 0 0 0 0
      0 0 0 0 0 0 0 0 0 0 0 0 0 0 0 0 0 0 0 0 0 0 0 0 0 0 0 0 0 0 0 0 0 0 0 0 0 0 0 0 0 0 0 0 0 0 0 0 0 0 0 0 0 0 0 0 0 0 0 0 0 0 0 0 0 0 0 0 0 0 0 0 0 0 0
      0 0 0 0 0 0 0 0 0 0 0 0 0 0 0 0 0 0 0 0 0 0 0 0 0 0 0 0 0 0 0 0 0 0 0 0 0 0 0 0 0 0 0 0 0 0 0 0 0 0 0 0 0 0 0 0 0 0 0 0 0 0 0 0 0 0 0 0 0 0 0 0 0 0 0
      0 0 0 0 0 0 0 0 0 0 0 0 0 0 0 0 0 0 0 0 0 0 0 0 0 0 0 0 0 0 0 0 0 0 0 0 0 0 0 0 0 0 0 0 0 0 0 0 0 0 0 0 0 0 0 0 0 0 0 0 0 0 0 0 0 0 0 0 0 0 0 0 0 0 0
      0 0 0 0 0 0 0 0 0 0 0 0 0 0 0 0 0 0 0 0 0 0 0 0 0 0 0 0 0 0 0 0 0 0 0 0 0 0 0 0 0 0 0 0 0 0 0 0 0 0 0 0 0 0 0 0 0 0 0 0 0 0 0 0 0 0 0 0 0 0 0 0 0 0 0
      )
    )
    (tilemap
      (solid #f)
      (z-pos 200)
      (width 75)
      (height 35)
      (tiles
      0 0 0 0 0 0 0 0 0 0 0 0 0 0 0 0 0 0 0 0 0 0 0 0 0 0 0 0 0 0 0 0 0 0 0 0 0 0 0 0 0 0 0 0 0 0 0 0 0 0 0 0 0 0 0 0 0 0 0 0 0 0 0 0 0 0 0 0 0 0 0 0 0 0 0
      0 0 0 0 0 0 0 0 0 0 0 0 0 0 0 0 0 0 0 0 0 0 0 0 0 0 0 0 0 0 0 0 0 0 0 0 0 0 0 0 0 0 0 0 0 0 0 0 0 0 0 0 0 0 0 0 0 0 0 0 0 0 0 0 0 0 0 0 0 0 0 0 0 0 0
      0 0 0 0 0 0 0 0 0 0 0 0 0 0 0 0 0 0 0 0 0 0 0 0 0 0 0 0 0 0 0 0 0 0 0 0 0 0 0 0 0 0 0 0 0 0 0 0 0 0 0 0 0 0 0 0 0 0 0 0 0 0 0 0 0 0 0 0 0 0 0 0 0 0 0
      0 0 0 0 0 0 0 0 0 0 0 0 0 0 0 0 0 0 0 0 0 0 0 0 0 0 0 0 0 0 0 0 0 0 0 0 0 0 0 0 0 0 0 0 0 0 0 0 0 0 0 0 0 0 0 0 0 0 0 0 0 0 0 0 0 0 0 0 0 0 0 0 0 0 0
      0 0 0 0 0 0 0 0 0 0 0 0 0 0 0 0 0 0 0 0 0 0 0 0 0 0 0 0 0 0 0 0 0 0 0 0 0 0 0 0 0 0 0 0 0 0 0 0 0 0 0 0 0 0 0 0 0 0 0 0 0 0 0 0 0 0 0 0 0 0 0 0 0 0 0
      0 0 0 0 0 0 0 0 0 0 0 0 0 0 0 0 0 0 0 0 0 0 0 0 0 0 0 0 0 0 0 0 0 0 0 0 0 0 0 0 0 0 0 0 0 0 0 0 0 0 0 0 0 0 0 0 0 0 0 0 0 0 0 0 0 0 0 0 0 0 0 0 0 0 0
      0 0 0 0 0 0 0 0 0 0 0 0 0 0 0 0 0 0 0 0 0 0 0 0 0 0 0 0 0 0 0 0 0 0 0 0 0 0 0 0 0 0 0 0 0 0 0 0 0 0 0 0 0 0 0 0 0 0 0 0 0 0 0 0 0 0 0 0 0 0 0 0 0 0 0
      0 0 0 0 0 0 0 0 0 0 0 0 0 0 0 0 0 0 0 0 0 0 0 0 0 0 0 0 0 0 0 0 0 0 0 0 0 0 0 0 0 0 0 0 0 0 0 0 0 0 0 0 0 0 0 0 0 0 0 0 0 0 0 0 0 0 0 0 0 0 0 0 0 0 0
      0 0 0 0 0 0 0 0 0 0 0 0 0 0 0 0 0 0 0 0 0 0 0 0 0 0 0 0 0 0 0 0 0 0 0 0 0 0 0 0 0 0 0 0 0 0 0 0 0 0 0 0 0 0 0 0 0 0 0 0 0 0 0 0 0 0 0 0 0 0 0 0 0 0 0
      0 0 0 0 0 0 0 0 0 0 0 0 0 0 0 0 0 0 0 0 0 0 0 0 0 0 0 0 0 0 0 0 0 0 0 0 0 0 0 0 0 0 0 0 0 0 0 0 0 0 0 0 0 0 0 0 0 0 0 0 0 0 0 0 0 0 0 0 0 0 0 0 0 0 0
      0 0 0 0 0 0 0 0 0 0 0 0 0 0 0 0 0 0 0 0 0 0 0 0 0 0 0 0 0 0 0 0 0 0 0 0 0 0 0 0 0 0 0 0 0 0 0 0 0 0 0 0 0 0 0 0 0 0 0 0 0 0 0 0 0 0 0 0 0 0 0 0 0 0 0
      0 0 0 0 0 0 0 0 0 0 0 0 0 0 0 0 0 0 0 0 0 0 0 0 0 0 0 0 0 0 0 0 0 0 0 0 0 0 0 0 0 0 0 0 0 0 0 0 0 0 0 0 0 0 0 0 0 0 0 0 0 0 0 0 0 0 0 0 0 0 0 0 0 0 0
      0 0 0 0 0 0 0 0 0 0 0 0 0 0 0 0 0 0 0 0 0 0 0 0 0 0 0 0 0 0 0 0 0 0 0 0 0 0 0 0 0 0 0 0 0 0 0 0 0 0 0 0 0 0 0 0 0 0 0 0 0 0 0 2950 0 0 0 0 0 0 0 0 0 0 0
      0 0 0 0 0 0 0 0 0 0 0 0 0 0 0 0 0 0 0 0 0 0 0 0 0 0 0 0 0 0 0 0 0 0 0 0 0 0 0 0 0 0 0 0 0 0 0 0 0 0 0 0 0 0 0 0 0 0 0 0 0 0 0 2951 0 0 0 0 0 0 0 0 0 0 0
      0 0 0 0 0 0 0 0 0 0 0 0 0 0 0 0 0 0 0 0 0 0 0 0 0 0 0 0 0 0 0 0 0 0 0 0 0 0 0 0 0 0 0 0 0 0 0 0 0 0 0 0 0 0 0 0 0 0 0 0 0 0 0 2951 0 0 0 0 0 0 0 0 0 0 0
      0 0 0 0 0 0 0 59 60 0 0 0 0 0 0 0 0 0 0 0 0 0 0 0 0 0 0 0 0 0 0 0 0 0 0 0 0 0 0 0 0 0 0 0 0 0 0 0 0 0 0 0 0 0 0 0 0 0 0 0 0 0 0 2951 2385 2385 2385 2385 2386 0 0 0 0 0 0
      0 0 0 0 0 0 0 59 60 0 0 0 0 0 0 0 0 0 0 0 0 0 0 0 0 0 0 0 0 0 0 0 0 0 0 0 0 0 0 0 0 0 0 0 0 0 0 0 0 0 0 0 0 0 0 0 0 0 0 0 0 0 0 2393 2954 2954 2954 2954 2954 0 0 0 0 0 0
      0 0 0 0 0 0 0 59 60 0 0 0 0 0 0 0 0 0 0 0 0 0 0 0 0 0 0 0 0 0 0 0 0 0 0 0 0 0 0 0 0 0 0 0 0 0 0 0 0 0 0 0 0 0 0 0 0 0 2949 0 0 0 0 0 0 0 0 0 0 0 0 0 0 0 0
      0 0 0 0 0 0 0 59 60 0 0 0 0 0 0 57 58 0 0 0 0 0 0 0 0 0 0 0 0 0 0 0 0 0 0 0 0 0 0 0 0 0 0 0 0 0 0 0 0 0 0 0 0 0 0 0 0 0 2950 0 0 0 0 0 0 0 0 0 0 0 0 0 0 0 0
      0 0 0 0 0 0 0 59 60 0 0 0 0 0 0 59 60 0 0 0 0 0 0 0 0 0 0 0 59 60 0 0 0 0 0 0 0 0 0 0 0 0 0 0 0 0 0 0 0 0 0 0 0 0 0 0 0 0 2951 0 0 0 0 0 0 0 0 0 0 0 0 0 0 0 0
      0 0 0 0 0 0 0 59 60 0 0 0 0 0 0 59 60 0 0 0 0 0 0 0 0 0 0 0 59 60 0 0 0 0 0 0 0 0 0 0 0 0 0 0 0 0 0 0 0 0 0 0 0 0 0 0 0 0 2951 0 0 0 0 0 0 0 0 0 0 0 0 0 0 0 0
      0 0 0 0 0 0 0 59 60 0 0 0 0 0 0 59 60 0 0 0 0 0 0 0 0 0 0 0 59 60 0 0 0 0 0 0 0 0 0 0 0 0 0 0 0 0 0 0 2954 2954 2954 2954 2954 2954 2954 2954 2954 2954 2395 0 0 0 0 0 0 0 0 0 0 0 0 0 0 0 0
      0 0 0 0 0 0 0 0 0 0 0 0 0 0 0 0 0 0 0 0 0 0 0 0 0 0 0 55 0 0 55 55 55 55 55 55 55 55 55 55 0 0 0 0 0 0 0 0 0 0 0 0 0 0 0 0 0 0 0 0 0 0 0 0 0 0 0 0 0 0 0 0 0 0 0
      0 0 0 0 0 0 0 0 0 0 0 0 0 0 0 0 0 0 0 0 0 0 0 0 0 0 0 0 0 0 0 0 0 0 0 0 0 0 0 0 0 0 0 0 0 0 0 0 0 0 0 0 0 0 0 0 0 0 0 0 0 0 0 0 0 0 0 0 0 0 0 0 0 0 0
      0 0 0 0 0 0 0 59 60 0 0 0 0 0 0 59 60 0 0 0 0 0 0 0 0 0 0 0 59 60 0 0 0 0 0 0 0 0 0 0 0 0 0 0 0 0 0 0 0 0 0 0 0 0 0 0 0 0 0 0 0 0 0 0 0 0 0 0 0 0 0 0 0 0 0
      0 0 0 0 0 0 0 0 60 0 0 0 0 0 0 59 60 0 0 0 0 0 0 0 0 0 0 75 59 60 75 75 75 75 75 75 75 75 0 0 0 0 0 0 0 0 0 0 0 0 0 0 0 0 0 0 0 0 0 0 0 0 0 0 0 0 0 0 0 0 0 0 0 0 0
      0 0 0 0 0 0 0 0 0 0 0 0 0 0 0 0 0 0 0 0 0 0 0 0 0 0 0 0 0 0 0 0 0 0 0 0 0 0 0 0 0 0 0 0 0 0 0 0 0 0 0 0 0 0 0 0 0 0 0 0 0 0 0 0 0 0 0 0 0 0 0 0 0 0 0
      0 0 0 0 0 0 0 0 0 0 0 0 0 0 0 0 0 0 0 0 0 0 0 0 0 0 0 0 0 0 0 0 0 0 0 0 0 0 0 0 0 0 0 0 0 0 0 0 0 0 0 0 0 0 0 0 0 0 0 0 0 0 0 0 0 0 0 0 0 0 0 0 0 0 0
      0 0 0 0 0 0 0 0 0 0 0 0 0 0 0 0 0 0 0 0 0 0 0 0 0 0 0 0 0 0 0 0 0 0 0 0 0 0 0 0 0 0 0 0 0 0 0 0 0 0 0 0 0 0 0 0 0 0 0 0 0 0 0 0 0 0 0 0 0 0 0 0 0 0 0
      0 0 0 0 0 0 0 0 0 0 0 0 0 0 0 0 0 0 0 0 0 0 0 0 0 0 0 0 0 0 0 0 0 0 0 0 0 0 0 0 0 0 0 0 0 0 0 0 0 0 0 0 0 0 0 0 0 0 0 0 0 0 0 0 0 0 0 0 0 0 0 0 0 0 0
      0 0 0 0 0 0 0 0 0 0 0 0 0 0 0 0 0 0 0 0 0 0 0 0 0 0 0 0 0 0 0 0 0 0 0 0 0 0 0 0 0 0 0 0 0 0 0 0 0 0 0 0 0 0 0 0 0 0 0 0 0 0 0 0 0 0 0 0 0 0 0 0 0 0 0
      0 0 0 0 0 0 0 0 0 0 0 0 0 0 0 0 0 0 0 0 0 0 0 0 0 0 0 0 0 0 0 0 0 0 0 0 0 0 0 0 0 0 0 0 0 0 0 0 0 0 0 0 0 0 0 0 0 0 0 0 0 0 0 0 0 0 0 0 0 0 0 0 0 0 0
      0 0 0 0 0 0 0 0 0 0 0 0 0 0 0 0 0 0 0 0 0 0 0 0 0 0 0 0 0 0 0 0 0 0 0 0 0 0 0 0 0 0 0 0 0 0 0 0 0 0 0 0 0 0 0 0 0 0 0 0 0 0 0 0 0 0 0 0 0 0 0 0 0 0 0
      0 0 0 0 0 0 0 0 0 0 0 0 0 0 0 0 0 0 0 0 0 0 0 0 0 0 0 0 0 0 0 0 0 0 0 0 0 0 0 0 0 0 0 0 0 0 0 0 0 0 0 0 0 0 0 0 0 0 0 0 0 0 0 0 0 0 0 0 0 0 0 0 0 0 0
      0 0 0 0 0 0 0 0 0 0 0 0 0 0 0 0 0 0 0 0 0 0 0 0 0 0 0 0 0 0 0 0 0 0 0 0 0 0 0 0 0 0 0 0 0 0 0 0 0 0 0 0 0 0 0 0 0 0 0 0 0 0 0 0 0 0 0 0 0 0 0 0 0 0 0
      )
    )
  )
)
